{
	"412": "af",
	"276": "al",
	"603": "dz",
	"544": "as",
	"213": "ad",
	"631": "ao",
	"365": "ai",
	"344": "ag",
	"722": "ar",
	"283": "am",
	"363": "aw",
	"505": "au",
	"232": "at",
	"400": "az",
	"364": "bs",
	"426": "bh",
	"470": "bd",
	"342": "bb",
	"257": "by",
	"206": "be",
	"702": "bz",
	"616": "bj",
	"350": "bm",
	"402": "bt",
	"736": "bo",
	"218": "ba",
	"652": "bw",
	"724": "br",
	"348": "vg",
	"528": "bn",
	"284": "bg",
	"613": "bf",
	"642": "bi",
	"456": "kh",
	"624": "cm",
	"302": "ca",
	"625": "cv",
	"346": "ky",
	"623": "cf",
	"622": "td",
	"730": "cl",
	"460": "cn",
	"732": "co",
	"654": "km",
	"629": "cg",
	"548": "ck",
	"712": "cr",
	"612": "ci",
	"219": "hr",
	"368": "cu",
	"280": "cy",
	"230": "cz",
	"630": "cd",
	"238": "dk",
	"638": "dj",
	"366": "dm",
	"370": "do",
	"514": "tl",
	"740": "ec",
	"602": "eg",
	"706": "sv",
	"627": "gq",
	"657": "er",
	"248": "ee",
	"636": "et",
	"750": "fk",
	"288": "fo",
	"542": "fj",
	"244": "fi",
	"208": "fr",
	"742": "gf",
	"547": "pf",
	"628": "ga",
	"607": "gm",
	"282": "ge",
	"262": "de",
	"620": "gh",
	"266": "gi",
	"202": "gr",
	"290": "gl",
	"352": "gd",
	"340": "gp",
	"535": "gu",
	"704": "gt",
	"611": "gn",
	"632": "gw",
	"738": "gy",
	"372": "ht",
	"708": "hn",
	"454": "hk",
	"216": "hu",
	"274": "is",
	"404": "in",
	"405": "in",
	"510": "id",
	"432": "ir",
	"418": "iq",
	"272": "ie",
	"425": "il",
	"222": "it",
	"338": "jm",
	"441": "jp",
	"440": "jp",
	"416": "jo",
	"401": "kz",
	"639": "ke",
	"545": "ki",
	"467": "kp",
	"450": "kr",
	"419": "kw",
	"437": "kg",
	"457": "la",
	"247": "lv",
	"415": "lb",
	"651": "ls",
	"618": "lr",
	"606": "ly",
	"295": "li",
	"246": "lt",
	"270": "lu",
	"455": "mo",
	"294": "mk",
	"646": "mg",
	"650": "mw",
	"502": "my",
	"472": "mv",
	"610": "ml",
	"278": "mt",
	"551": "mh",
	"340": "mq",
	"609": "mr",
	"617": "mu",
	"334": "mx",
	"550": "fm",
	"259": "md",
	"212": "mc",
	"428": "mn",
	"297": "me",
	"354": "ms",
	"604": "ma",
	"643": "mz",
	"414": "mm",
	"649": "na",
	"536": "nr",
	"429": "np",
	"204": "nl",
	"362": "an",
	"546": "nc",
	"530": "nz",
	"710": "ni",
	"614": "ne",
	"621": "ng",
	"534": "mp",
	"242": "no",
	"422": "om",
	"410": "pk",
	"552": "pw",
	"423": "ps",
	"714": "pa",
	"537": "pg",
	"744": "py",
	"716": "pe",
	"515": "ph",
	"260": "pl",
	"268": "pt",
	"330": "pr",
	"427": "qa",
	"647": "re",
	"226": "ro",
	"250": "ru",
	"635": "rw",
	"356": "kn",
	"358": "lc",
	"308": "pm",
	"360": "vc",
	"549": "ws",
	"292": "sm",
	"626": "st",
	"420": "sa",
	"608": "sn",
	"220": "rs",
	"633": "sc",
	"619": "sl",
	"525": "sg",
	"231": "sk",
	"293": "si",
	"540": "sb",
	"637": "so",
	"655": "za",
	"214": "es",
	"413": "lk",
	"634": "sd",
	"746": "sr",
	"653": "sz",
	"240": "se",
	"228": "ch",
	"417": "sy",
	"466": "tw",
	"436": "tj",
	"640": "tz",
	"520": "th",
	"615": "tg",
	"539": "to",
	"374": "tt",
	"605": "tn",
	"286": "tr",
	"438": "tm",
	"376": "tc",
	"641": "ug",
	"255": "ua",
	"424": "ae",
	"430": "ae",
	"431": "ae",
	"235": "gb",
	"234": "gb",
	"310": "us",
	"311": "us",
	"312": "us",
	"313": "us",
	"314": "us",
	"315": "us",
	"316": "us",
	"332": "vi",
	"748": "uy",
	"434": "uz",
	"541": "vu",
	"225": "va",
	"734": "ve",
	"452": "vn",
	"543": "wf",
	"421": "ye",
	"645": "zm",
	"648": "zw"	
}